emanano emana	emanare	Mood=Ind|Number=Plur|Person=3|Tense=Pres|VerbForm=Fin
presidiano presidia	presidiare	Mood=Ind|Number=Plur|Person=3|Tense=Pres|VerbForm=Fin
mantengono mantiene	mantenere	Mood=Ind|Number=Plur|Person=3|Tense=Pres|VerbForm=Fin
spinsero spinse	spingere	Mood=Ind|Number=Plur|Person=3|Tense=Past|VerbForm=Fin
caldeggiati caldeggiato	caldeggiare	Gender=Masc|Number=Plur|Tense=Past|VerbForm=Part
collaborarono collaborò	collaborare	Mood=Ind|Number=Plur|Person=3|Tense=Past|VerbForm=Fin
provocarono provoca	provocare	Mood=Ind|Number=Plur|Person=3|Tense=Pres|VerbForm=Fin
afflitto afflitti	affliggere	Gender=Masc|Number=Sing|Tense=Past|VerbForm=Part
formulano formula	formulare	Mood=Ind|Number=Plur|Person=3|Tense=Pres|VerbForm=Fin
enunciato enunciati	enunciare	Gender=Masc|Number=Sing|Tense=Past|VerbForm=Part
cinguettante cinguettanti	cinguettare	Number=Sing|Tense=Pres|VerbForm=Part
tornano torna	tornare	Mood=Ind|Number=Plur|Person=3|Tense=Pres|VerbForm=Fin
mirino miri	mirare	Mood=Sub|Number=Plur|Person=3|Tense=Pres|VerbForm=Fin
sfrutta sfruttano	sfruttare	Mood=Ind|Number=Sing|Person=3|Tense=Pres|VerbForm=Fin
distrugge distruggono	distruggere	Mood=Ind|Number=Sing|Person=3|Tense=Pres|VerbForm=Fin
mendaci mendace	mendace	Number=Plur
contattano contatta	contattare	Mood=Ind|Number=Plur|Person=3|Tense=Pres|VerbForm=Fin
divelto divelti	divellere	Gender=Masc|Number=Sing|Tense=Past|VerbForm=Part
predisposte predisposta	predisporre	Gender=Fem|Number=Plur|Tense=Past|VerbForm=Part
transita transitano	transitare	Mood=Ind|Number=Sing|Person=3|Tense=Pres|VerbForm=Fin
scoppiato scoppiati	scoppiare	Gender=Masc|Number=Sing|Tense=Past|VerbForm=Part
vinceranno vincerà	vincere	Mood=Ind|Number=Plur|Person=3|Tense=Fut|VerbForm=Fin
arriveremo arriverò	arrivare	Mood=Ind|Number=Plur|Person=1|Tense=Fut|VerbForm=Fin
uso usiamo	usare	Mood=Ind|Number=Sing|Person=1|Tense=Pres|VerbForm=Fin
nuvola nuvole	nuvola	Gender=Fem|Number=Sing
attestano attesta	attestare	Mood=Ind|Number=Plur|Person=3|Tense=Pres|VerbForm=Fin
diventino diventi	diventare	Mood=Sub|Number=Plur|Person=3|Tense=Pres|VerbForm=Fin
inscenate inscenata	inscenare	Gender=Fem|Number=Plur|Tense=Past|VerbForm=Part
gialli giallo	giallo	Gender=Masc|Number=Plur
pressati pressato	pressare	Gender=Masc|Number=Plur|Tense=Past|VerbForm=Part
sparso sparsi	spargere	Gender=Masc|Number=Sing|Tense=Past|VerbForm=Part
saggezze saggezza	saggezza	Gender=Fem|Number=Plur
disegnano disegna	disegnare	Mood=Ind|Number=Plur|Person=3|Tense=Pres|VerbForm=Fin
divelto divelti	divellere	Gender=Masc|Number=Sing|Tense=Past|VerbForm=Part
radioattivo radioattivi	radioattivo	Gender=Masc|Number=Sing
stuprate stuprata	stuprare	Gender=Fem|Number=Plur|Tense=Past|VerbForm=Part
puntate puntata	puntare	Gender=Fem|Number=Plur|Tense=Past|VerbForm=Part
volute voluta	volere	Gender=Fem|Number=Plur|Tense=Past|VerbForm=Part
approffittò approfittarono	approfittare	Mood=Ind|Number=Sing|Person=3|Tense=Past|VerbForm=Fin
aggredite aggredita	aggredire	Gender=Fem|Number=Plur|Tense=Past|VerbForm=Part
intatti intatto	intatto	Gender=Masc|Number=Plur
dittatori dittatore	dittatore	Gender=Masc|Number=Plur
esprima esprimano	esprimere	Mood=Sub|Number=Sing|Person=3|Tense=Pres|VerbForm=Fin
prescrivono prescrive	prescrivere	Mood=Ind|Number=Plur|Person=3|Tense=Pres|VerbForm=Fin
istituiscono istituisce	istituire	Mood=Ind|Number=Plur|Person=3|Tense=Pres|VerbForm=Fin
superavano superava	superare	Mood=Ind|Number=Plur|Person=3|Tense=Imp|VerbForm=Fin
rapide rapida	rapido	Gender=Fem|Number=Plur
equivalgono equivale	equivalere	Mood=Ind|Number=Plur|Person=3|Tense=Pres|VerbForm=Fin
accorso accorsi	accorrere	Gender=Masc|Number=Sing|Tense=Past|VerbForm=Part
violentate violentata	violentare	Gender=Fem|Number=Plur|Tense=Past|VerbForm=Part
fantasioso fantasiosi	fantasioso	Gender=Masc|Number=Sing
colorata colorate	colorare	Gender=Fem|Number=Sing|Tense=Past|VerbForm=Part
usate usata	usare	Gender=Fem|Number=Plur|Tense=Past|VerbForm=Part
seguite segui	seguire	Mood=Imp|Number=Plur|Person=2|Tense=Pres|VerbForm=Fin
combatte combattono	combattere	Mood=Ind|Number=Sing|Person=3|Tense=Pres|VerbForm=Fin
scandalizzavano scandalizzava	scandalizzare	Mood=Ind|Number=Plur|Person=3|Tense=Imp|VerbForm=Fin
diedero diede	dare	Mood=Ind|Number=Plur|Person=3|Tense=Past|VerbForm=Fin
convertito convertiti	convertire	Gender=Masc|Number=Sing|Tense=Past|VerbForm=Part
stavano stava	stare	Mood=Ind|Number=Plur|Person=3|Tense=Imp|VerbForm=Fin
iscritte iscritta	iscrivere	Gender=Fem|Number=Plur|Tense=Past|VerbForm=Part
criticata criticate	criticare	Gender=Fem|Number=Sing|Tense=Past|VerbForm=Part
decompone decompongono	decomporre	Mood=Ind|Number=Sing|Person=3|Tense=Pres|VerbForm=Fin
avvenute avvenuta	avvenire	Gender=Fem|Number=Plur|Tense=Past|VerbForm=Part
decomposizioni decomposizione	decomposizione	Gender=Fem|Number=Plur
risulti risultino	risultare	Mood=Sub|Number=Sing|Person=3|Tense=Pres|VerbForm=Fin
alimentarono alimentò	alimentare	Mood=Ind|Number=Plur|Person=3|Tense=Past|VerbForm=Fin
divertirono divertì	divertire	Mood=Ind|Number=Plur|Person=3|Tense=Past|VerbForm=Fin
sapevamo sapevo	sapere	Mood=Ind|Number=Plur|Person=1|Tense=Imp|VerbForm=Fin
richiamano richiama	richiamare	Mood=Ind|Number=Plur|Person=3|Tense=Pres|VerbForm=Fin
autorizzate autorizzata	autorizzare	Gender=Fem|Number=Plur|Tense=Past|VerbForm=Part
intuizioni intuizione	intuizione	Gender=Fem|Number=Plur
alimentata alimentate	alimentare	Gender=Fem|Number=Sing|Tense=Past|VerbForm=Part
provengono proviene	provenire	Mood=Ind|Number=Plur|Person=3|Tense=Pres|VerbForm=Fin
digitalizzato digitalizzati	digitalizzare	Gender=Masc|Number=Sing|Tense=Past|VerbForm=Part
devastato devastati	devastare	Gender=Masc|Number=Sing|Tense=Past|VerbForm=Part
artistiche artistica	artistico	Gender=Fem|Number=Plur
firmate firmata	firmare	Gender=Fem|Number=Plur|Tense=Past|VerbForm=Part
riadattate riadattata	riadattare	Gender=Fem|Number=Plur|Tense=Past|VerbForm=Part
disegnano disegna	disegnare	Mood=Ind|Number=Plur|Person=3|Tense=Pres|VerbForm=Fin
compromisero compromise	compromettere	Mood=Ind|Number=Plur|Person=3|Tense=Past|VerbForm=Fin
abbassano abbassa	abbassare	Mood=Ind|Number=Plur|Person=3|Tense=Pres|VerbForm=Fin
riguardava riguardavano	riguardare	Mood=Ind|Number=Sing|Person=3|Tense=Imp|VerbForm=Fin
pesavano pesava	pesare	Mood=Ind|Number=Plur|Person=3|Tense=Imp|VerbForm=Fin
emanano emana	emanare	Mood=Ind|Number=Plur|Person=3|Tense=Pres|VerbForm=Fin
rifiutano rifiuta	rifiutare	Mood=Ind|Number=Plur|Person=3|Tense=Pres|VerbForm=Fin
riportò riportarono	riportare	Mood=Ind|Number=Sing|Person=3|Tense=Past|VerbForm=Fin
trattengo tratteniamo	trattenere	Mood=Ind|Number=Sing|Person=1|Tense=Pres|VerbForm=Fin
sparati sparato	sparare	Gender=Masc|Number=Plur|Tense=Past|VerbForm=Part
riferita riferite	riferire	Gender=Fem|Number=Sing|Tense=Past|VerbForm=Part
atmosfere atmosfera	atmosfera	Gender=Fem|Number=Plur
aprite apri	aprire	Mood=Imp|Number=Plur|Person=2|Tense=Pres|VerbForm=Fin
violentate violentata	violentare	Gender=Fem|Number=Plur|Tense=Past|VerbForm=Part
cesserà cesseranno	cessare	Mood=Ind|Number=Sing|Person=3|Tense=Fut|VerbForm=Fin
accendono accende	accendere	Mood=Ind|Number=Plur|Person=3|Tense=Pres|VerbForm=Fin
sovietica sovietiche	sovietico	Gender=Fem|Number=Sing
infiltrato infiltrati	infiltrare	Gender=Masc|Number=Sing|Tense=Past|VerbForm=Part
vivevano viveva vivere